29 13
#############################
#p    1*b *  1 *   *  * *   #
# #   #*# # #*#*# # # #*#*# #
#  x*    3 ***  *  1  *   * #
# # # # # #*# # #*#*# # # #*#
#f  3  4   x **  *  *   6   #
# # # # # # # # # #*# #*# # #
#*  s   4  *  *  6   *  5   #
# # # # #*# # # #*#*# # # # #
#*    **  *    4  *     2   #
# #*# # # # # # #*# # # # # #
#      5    *   *  * 2      #
#############################

